322222231
EEEWWWWSWEEE
EEEEEWWOEEEE
EWEEWWWWEEEE
EWEEGEEEEEEE
SWEAWEEEEEEE
WWWWWKWWWWEE
WWEEEEEWEEEW   
SEEEWAWWEEEW
WWWWWWWWEEEW
EESWWGEEEEEW
GWWWEEEEEEWW
EEEEEEEEEWWW
